.#...#......
.........#..
..#........#
#.....#.....
.........#..
.....#......
..#......#..
............
.#...#....#.
.......#....
..#.........
#.....#.....
............
............
..#.........
...........#
............
.....#......
............
............
......@.....
